/////////////////////////////////////////////////
/                                               /
/     o                                         /
/                                               /
///////////////////                             /
///////////////////                             /
/                                               / 
/                     ///                       /
/                     ///             //        /
/                     ///                       /
/                     ///                       /
/        //                                     /
/        //             X                       /
/                              //               /    
/                                               /
/                                               /  
/                                       g       /
/                                               /
/////////////////////////////////////////////////